MAI = "countries/CentralKingdom.txt"
GRN = "countries/Greenland2.txt"
ICW = "countries/Iceworld.txt"
DES = "countries/Desert.txt"
FRI = "countries/FriedewaldKingdom.txt"
WEK = "countries/WesternKingdom.txt"
SLD = "countries/Spalding.txt"
ENC = "countries/Enchancia.txt"
AVA = "countries/Avalor.txt"
WEI = "countries/WeiLing.txt"
KHA = "countries/Khaldoun.txt"
COR = "countries/Corinthia.txt"
ZUM = "countries/Zumaria.txt"
RUD = "countries/Rudistan.txt"
TRU = "countries/Trufflandia.txt"
MAR = "countries/Maarswik.txt"
ISL = "countries/Isleworth.txt"
FLO = "countries/FlowerHill.txt"
WEA = "countries/Weasels.txt"
WOL = "countries/Wolves.txt"
EN1 = "countries/JamesSupporters.txt"
EN2 = "countries/AmberSupporters.txt"
EN3 = "countries/CedricSupporters.txt"
EN4 = "countries/EnchancianPeople.txt"
TUG = "countries/TunguPungu.txt"
WIN = "countries/Winslowonexile.txt"
OUT = "countries/Outcasts.txt"
RAB = "countries/Rabbits.txt"
NTR = "countries/NorthernRepublic.txt"
DUC = "countries/Ducks.txt"
SQU = "countries/SquirrelRepublic.txt"
BIR = "countries/Eagles.txt"
EAP = "countries/Eapes.txt"
DUL = "countries/Duloc.txt"
FFA = "countries/FarFarAway.txt"
SWA = "countries/Swamp.txt"
PAT = "countries/Ajeto.txt"
TSA = "countries/TriStateArea.txt"
TRL = "countries/Turtles.txt"
SAL = "countries/Salamanders.txt"
SIO = "countries/Sioux.txt"
DCB = "countries/Duckburg.txt"
GON = "countries/GongmenEmpire.txt"
KPT = "countries/StarfleetColony.txt"
JPN = "countries/Japanifornia.txt"
HAR = "countries/HartmutKingdom.txt"
SKO = "countries/AlienSultan.txt"
UND = "countries/Underground.txt"
MUS = "countries/MushroomKingdom.txt"
VIS = "countries/VineshroomRepublic.txt"
ICK = "countries/IceKingdom.txt"
FRK = "countries/FireKingdom.txt"
CDK = "countries/CandyKingdom.txt"
GUM = "countries/GummiBears.txt"
LEC = "countries/LechinaEmpire.txt"
BRO = "countries/Bronks.txt"
GRY = "countries/Gryfs.txt"
SAN = "countries/SanEscobar.txt"
SMU = "countries/Smurfs.txt"
PDX = "countries/Paradoxawka.txt"
MOO = "countries/Moomins.txt"
DOF = "countries/Doofania.txt"
KHU = "countries/Khurain.txt"
GLO = "countries/GloomyForest.txt"
WLC = "countries/WeiLingCommune.txt"
NRL = "countries/NelandRepublic.txt"
JOE = "countries/Joelreich.txt"


#############
UNC = "countries/Wilderness.txt"

#############
#OCCUPATION ZONES USED
#############
SKD = "countries/SultanKommissariatDumbarton.txt"
SKL = "countries/SultanKommissariatLubniewice.txt"
SKP = "countries/SultanKommissariatPyrzyce.txt"
SKA = "countries/SultanKommissariatPantmawr.txt"
SKJ = "countries/SultanKommissariatJapanifornia.txt"
SKK = "countries/SultanKommissariatKhurain.txt"
SKM = "countries/SultanKommissariatMoomins.txt"
WGO = "countries/WestGongmen.txt"
EGO = "countries/EastGongmen.txt"
STW = "countries/StarfleetWesternSector.txt"
SMP = "countries/SouthernMushroomProt.txt"
TPR = "countries/TrebbioProt.txt"
MPR = "countries/MaranzaProt.txt"
MAU = "countries/MaunoProt.txt"
SLR = "countries/SouthernLechina.txt"
WAR = "countries/Wadowice.txt"
MYS = "countries/Myszyniec.txt"
GR2 = "countries/GGGreenland.txt"
GR3 = "countries/GGSioux.txt"
GR4 = "countries/SouthwestGreenland.txt"
GR5 = "countries/SoutheastGreenland.txt"
DUM = "countries/DumbartonProt.txt"
KAR = "countries/KarlinoProt.txt"
WEN = "countries/WesternEnchancia.txt"
EEN = "countries/EasternEnchancia.txt"
DUN = "countries/Dunwiddie.txt"
SRD = "countries/Sardinnoza.txt"
SMM = "countries/Summerset.txt"
OFL = "countries/OccupiedFlowerHill.txt"
WDK = "countries/Windknight.txt"
WHI = "countries/Whitechapel.txt"

############# v0.2
TIG = "countries/TigerClan.txt"
BEE = "countries/BeeKingdom.txt"
JOJ = "countries/Jojo.txt"
DIO = "countries/Dio.txt"
MIC = "countries/MiceRepublic.txt"
HOR = "countries/Hornets.txt"
FLE = "countries/FlensburgColony.txt"
SIX = "countries/SiouxExile.txt"
PIL = "countries/PillarMen.txt"
MOR = "countries/Morioh.txt"
ARE = "countries/Arendelle.txt"
KHO = "countries/Khorinis.txt"
BER = "countries/Berk.txt"
VIC = "countries/VicViking.txt"
LAL = "countries/LalaloopsyLand.txt"
MO2 = "countries/TheTrueMorioh.txt"
PAS = "countries/Passione.txt"
GIO = "countries/PassioneGiorno.txt"
SOO = "countries/Sooty.txt"
ELW = "countries/Elwood.txt"
WOR = "countries/Worcestershire.txt"
CLD = "countries/ChildrenRepublic.txt"
GEN = "countries/GeneralDomain.txt"
KLU = "countries/KluKluRebels.txt"
DRG = "countries/DragonRepublic.txt"

#############
#OCCUPATION ZONES UNUSED
#############
#E1N = "countries/1EnchancianOccupationZone.txt"
#E2N = "countries/2EnchancianOccupationZone.txt"
#E3N = "countries/3EnchancianOccupationZone.txt"
#C1E = "countries/1CentralKingdomOccupationZone.txt"
#C2E = "countries/2CentralKingdomOccupationZone.txt"
#C3E = "countries/3CentralKingdomOccupationZone.txt"
#G1R = "countries/1GreenlandOccupationZone.txt"
#G2R = "countries/2GreenlandOccupationZone.txt"
#G3R = "countries/3GreenlandOccupationZone.txt"

